11111111111111111111
1101C100000000100001
10000000000001C10E11
1000000000P000000001
11111111111111111111