111111111111111111111111111111111111111111111111111111111
1000000000000000000000000000000000000E0000000000000000001
111111111111111100000000000011111111111111000010000000001
111111111111111100000000000011111111111111000001000000001
111111100000000000000000000000000000000000000010000000001
100000000000000000000000011111111110000000000000000000001
100000C000000000C00000000000000000000000000000000000C0001
100000000000000000000000000000000000000000000000000000001
1P1000000000000000000000000000000000000000000000000000001
111111111111111111111111111111111111111111111111111111111